1c=イチカ
1g=ムツキ
1j=イチジョウ
1m=イチミヤ
1r=イチロウ
1z=イチホ
2d=ツヤマ
2j=ツジ
2m=ニノミヤ
2p=ニヘイ
2r=ジロウ
2t=ツダ
2v=ツヨシ
33=ゾウ
3g=ヤヨイ
3k=ミツコ
3l=ミツオ
3p=サンペイ
3q=ミエ
3r=サブロウ
3t=ミタ
3v=ミヨシ
3w=ミワ
4r=シロウ
4z=シミズ
5g=サツキ
5j=ゴジョウ
5r=ゴロウ
6r=ロクロウ
7c=ナナカ
7k=ナナコ
7l=ナナオ
7m=ナナミ
7q=ナナエ
7r=シチロウ
7s=ナナセ
7z=ナナホ
8b=ヤベ
8g=ハヅキ
8j=ヤギ
8q=ヤエ
8r=ハチロウ
8t=ハッタ
8x=ヤノ
9r=クロウ
b8=スズキ
bc=マチ
bf=マナ
bh=マヒロ
bj=マキ
bl=サキ
bm=マミ
br=マリ
kub=クボ
by=マユ
bz=マホ
bn=マヤ
c2=タケジ
c4=カヨ
c8=タケト
cb=チバ
cf=カナ
cg=タケマサ
cih=チヒロ
cj=カジ
ck=タケコ
cl=タケオ
cm=タケモト
cip=チハル
cq=チエ
cs=チサ
ct=カタ
cv=タケヨシ
cw=タケカズ
cy=チヨ
cz=カホ
cki=タケイ
ce=チエ
cn=カネ
d2=クウフクジ
d3=ヅカ
d4=トクテイ
d5=シケンシン
d6=コクホ
d7=ショクゼン
d8=ヤマト
d9=ヤマモト
dc=ツチ
dg=ヤマグチ
dj=ヤマキ
dk=トク
dl=ヤマオ
dm=ヤマ
dp=ヤマデラ
dr=ユメ
ds=ヤマサキ
dx=ヤマノ
dz=ヤマザキ
dn=ヤマナカ
f2=ナツ
f4=フミヨ
fc=フミカ
fd=ヨシ
fg=ナギ
fh=フミヒロ
fj=フジ
fk=フミコ
fl=フミオ
fm=フミ
fp=フミハル
fq=フミエ
fs=フカ
fv=フミヨシ
fw=フミカズ
fx=フミノ
fy=フミユキ
fz=ナホ
fn=フミヤ
g1=マサイチ
g2=マサジ
g3=マサゾウ
g4=マサヨ
g8=マサト
gc=グチ
gd=タケシ
gf=マサフミ
gh=マサヒロ
gj=マサキ
gk=マサコ
gl=マサオ
gm=マサミ
gp=ゴトウ
gq=マサエ
gs=マサシ
gt=ガツ
gv=マサヨシ
gx=マサノ
gy=マサユキ
gn=マサヤ
h1=ヒロイチ
h2=ヒロム
h3=ヒロシ
h4=ハラ
h8=ヒロト
hc=ヒコ
hf=ヒロフミ
hg=ハギ
hj=ヒロキ
hk=ヒロコ
hl=ヒロオ
hm=ヒロミ
hp=ヒロハル
hq=ヒロエ
hs=ヒロセ
ht=ヒロタ
hv=ヒロヨシ
hw=ヒロカズ
hx=ヒラ
hy=ヒロユキ
hn=ヒロヤ
j1=ジュンイチ
j2=ジュンジ
j3=ジュンゾウ
jc=キチ
jd=ミツル
jf=ジュンナ
jh=ヒトシ
jk=ジュンコ
jl=スミ
jm=キミ
jp=ジュンペイ
jr=ジロウ
js=キシ
jt=ジュンタ
jx=ジン
jn=ジュン
k1=ケンイチ
k2=ケンジ
k3=ケンゾウ
k4=キヨシ
k5=ケンゴ
k8=ケント
kd=コヤマ
kf=ハナ
kh=コウ
km=クミ
kp=カトウ
kq=キヨ
kr=カオリ
ks=ケンシン
kt=ケンタ
kv=マサル
kw=カワ
kz=カツ
kn=ケン
l8=オト
ld=ヨコ
m2=ヒカル
m3=ヒカル
m4=ミヨ
m8=ミヤ
mc=ミカ
mf=モリ
mh=ミヒロ
mj=ミキ
mk=マコト
ml=モエ
mp=ミハル
mq=ミエ
mr=ムラ
ms=ミサ
mt=マツ
my=ミユキ
mz=ミズ
p3=ハルゾウ
p4=ハルヨ
p8=ハルト
p9=ハルク
pb=ハルマ
pc=ハルカ
pf=ハルナ
pg=ハルマサ
ph=ハルヒロ
pj=ハルキ
pk=ハルコ
pl=ハルオ
pm=ハルミ
pq=ハルエ
pt=ハルタ
pv=ハルヨシ
px=ハルノ
py=ハルユキ
pn=ハルヤ
q4=ヒサヨ
q8=ヒサト
qg=エグチ
qk=ヒサコ
ql=ヒサオ
qp=ヒサハル
qq=ヒサエ
qs=ヒサシ
r1=リョウイチ
r2=リョウジ
r3=リョウゾウ
r5=リョウゴ
r8=リョウト
r9=リク
rb=リョウマ
rc=リョウカ
rf=レナ
rg=リョウガ
rh=リュウ
rk=リョウコ
rl=リョウヤ
rm=ルミ
rq=リエ
rs=リサ
rt=リョウタ
rx=リン
ry=リョウ
rz=リホ
rn=ハヤシ
s1=シンイチ
s2=シンジ
s3=シンゾウ
s4=サヨ
s5=シンゴ
sb=シバ
sc=サカ
sf=サナ
sg=シゲル
sh=シュウ
sj=アラタ
sk=ササキ
sl=サヤ
sm=シマ
sp=サトウ
sq=サエ
sr=サクラ
st=サイトウ
sv=セイ
sx=サノ
sy=ショウ
sz=サワ
sn=シン
t1=タイチ
t3=ツカ
t4=タカシ
t5=トオル
t8=タキ
tc=ノボル
td=トダ
tf=ツウフウ
th=タカハシ
tj=トキ
tk=タナカ
tm=トモ
tp=テラ
tq=タエ
tr=タロウ
ts=トシ
tv=タニ
ty=ユタカ
tz=チホ
v1=ヨシイチ
v3=ヨシゾウ
v8=ヨシト
vc=ヨシカ
vg=ヨシマサ
vh=ヨシヒロ
vj=ヨシキ
vk=ヨシコ
vl=ヨシオ
vm=ヨシモト
vp=ヨシハル
vq=ヨシエ
vr=ヨシロウ
vt=ヨシダ
vw=ヨシカズ
vx=ヨシノ
vy=ヨシユキ
vz=ヨシザキ
vn=ヨシヤ
w1=カズイチ
w4=カズヨ
w8=カズト
wb=カズマ
wc=ワカ
wd=ワダ
wf=カズフミ
wg=カズマサ
wh=カズヒロ
wj=カズキ
wk=カズコ
wl=カズオ
wm=カズミ
wp=カズハル
wq=カズエ
ws=カズシ
wt=ワタナベ
wv=カズヨシ
wy=カズユキ
wz=カズホ
wn=カズヤ
xf=サトフミ
xg=ノグチ
xm=ノモト
xr=サトル
xs=サトシ
xt=ノダ
xz=ノザキ
xn=オノ
y4=ユキヨ
y8=ユキト
yb=ユマ
yf=ユキナ
yg=ヤナギ
yh=ユキヒロ
yj=ユキ
yk=ユキコ
yl=ユキオ
ym=ユミ
yp=ユキハル
yq=ユキエ
yr=ユリ
ys=ヤスシ
yw=ユキカズ
yx=ユキノ
yn=ユキヤ
z1=ゼンイチ
z2=ゼンジ
z3=ゼンゾウ
z4=マツヨ
zd=マツヤマ
zf=マエ
zj=マツキ
zk=マツコ
zl=マツオ
zm=マツモト
zq=マツエ
zt=マツダ
zx=マツノ
zy=マツユキ
zn=マツヤ
bb=ババ
cc=チカ
ff=キタ
gg=ナガ
hh=ヒロ
jj=ジョウ
kk=ノリコ
ll=ユイ
mm=モモ
pp=ハル
rr=アキラ
ss=シュン
tt=タカ
vv=コ
ww=カズ
yy=ユウ
zz=ザワ
ab=アベ
ad=アカ
aj=アキ
al=アヤ
ap=アンドウ
ats=アツシ
as=アサ
ax=アン
ay=アユ
az=アズマ
if=イナ
ig=イガラシ
ip=イトウ
ir=イチロウ
is=イシ
it=イチ
iw=イワ
iiz=イズミ
uc=ウチ
ur=ウラ
ux=ウノ
ek=エイコ
em=エミ
ep=エンドウ
er=エリ
es=テツ
oc=オカ
od=オダ
oj=オオキ
ok=オオツカ
os=オサキ
ot=オダ
ox=オオノ
nb=ノブ
nd=ナカヤマ
nf=ナナ
nj=ナオキ
nk=ナカ
nl=ナオ
nm=ナカムラ
np=ナイトウ
nq=ヤエ
ns=ニシ
nx=ナカノ
nz=ノゾミ
;;3文字
kax=カンノ
kid=コイデ
kik=コイケ
kir=ケンイチロウ
kiw=コイワ
kiz=コイズミ
giw=ヨシカズ
gix=ヨシノ
giy=ヨシユキ
kup=クドウ
ked=カエデ
keg=ケイゴ
keh=ケイト
kej=ケイジ
kob=コバヤシ
kow=コウジ
kox=コンノ
goc=マサオカ
sak=サク
saq=サエ
sir=シンイチロウ
siz=シホ
jir=ジュンイチロウ
jis=ギシ
sud=スヤマ
sup=スドウ
zur=マツウラ
sej=セキ
ser=セリ
sob=ソウマ
sop=カナデ
sor=ソラ
tak=スグル
tax=タンノ
tur=タウラ
duc=ヤマウチ
dur=ヤマウラ
tod=トオヤマ
tot=ミヤコ
doc=ヤマオカ
dor=ツトム
nis=ニシ
nem=ネモト
noz=ノザキ
ham=ハマ
hat=ヒロアツ
bab=ババ
hif=ヒナ
hig=ヒグチ
fuk=トミコ
hoc=ヒロオカ
hor=ホリ
hot=タモツ
poc=クニオカ
pog=クニマサ
poh=クニヒロ
pom=クニモト
pop=クニハル
poq=クニエ
pov=クニヨシ
pow=クニカズ
poy=クニユキ
mal=マアヤ
maz=マホ
mic=ミチ
mif=ミナ
mik=ミク
mis=ミサ
miz=シミズ
mup=ムトウ
mir=ミウラ
mej=マエジマ
mex=マエノ
mey=マエヤマ
yas=ユアサ
yax=ヤノ
ric=リカ
rif=リナ
rik=リク
rir=リョウイチロウ
ris=リサ
rec=レイカ
ref=レイナ
rej=レイジ
rer=レイラ
waj=ワキ
1gj=ムツキ
1gm=ムツミ
1gq=ムツエ
1gg=ムツ
1nm=イチノミヤ
1ns=イチノセ
22m=ツツミ
2bj=ツバキ
2jm=ツジモト
2kd=ニカイドウ
2mr=ツムラ
2sm=ツシマ
2nm=ニノミヤ
33r=ザブロウ
3cy=ミチヨ
3fn=ミフネ
3h4=ミハラ
3hb=ミツハシ
3hs=ミツハシ
3jl=ミスミ
3km=ミカミ
3kw=ミカワ
3mr=ミムラ
3sm=ミシマ
3sw=ミサワ
3sz=ミサワ
3tv=ミタニ
3tn=ミタニ
3yk=ミヤケ
3zz=ミサワ
3is=ミツイシ
3ur=ミウラ
3nm=サンノミヤ
44r=ヨシロウ
4hl=ヨツバ
4my=シノミヤ
4nm=シノミヤ
8bj=ヤマキ
8cy=ヤチヨ
8dc=トヅカ
8dy=ヤシロ
8gm=ヤガミ
8gw=トガワ
8jm=ヤジマ
8mr=トムラ
8sm=ヤシマ
8sr=ヤシロ
8t3=トツカ
8zz=ヤザワ
b88=スズ
b8c=スズカ
b8f=スズナ
b8m=スズミ
b8q=スズエ
b8z=スズホ
b8n=スズヤ
c76=ヒダリミミ
c96=ミギミミ
cij=チアキ
ciz=チホ
cuc=タケウチ
coc=タケオカ
f23=ナツミ
f24=ナツヨ
f2j=ナツキ
f2m=ナツミ
f2q=ナツエ
f2x=ナツノ
f2z=ナツホ
h24=ハツヨ
h2m=ハツミ
h2q=ハツエ
h4g=ハラグチ
h4j=ハラキ
j1r=ジュンイチロウ
j3r=キサブロウ
k1r=ケンイチロウ
k2r=ケンジロウ
k3r=ケンザブロウ
kq8=キヨト
kqc=キヨカ
kqf=キヨフミ
kqg=キヨマサ
kqh=キヨヒロ
kqm=キヨミ
k4r=ケンシロウ
kqw=キヨカズ
kqx=キヨノ
kqy=キヨユキ
kqq=キヨエ
m1m=ムツミ
m34=ミツヨ
m3g=ミツマサ
m3h=ミツヒロ
m3j=ミツキ
m3m=ミツモト
m3p=ミツハル
m3q=ミツエ
m3v=ミツヨシ
m3y=ミツユキ
m3i=ミツイ
m3n=ミツヤ
r2r=リョウジロウ
r98=リクト
s1r=シンイチロウ
s2j=シンジロウ
s2r=シンジロウ
t3m=ツカモト
t4r=トシロウ
t8d=タキヤマ
t8g=タキグチ
t8m=タキモト
t8q=タキエ
t8x=タキノ
t8i=タキイ
t9r=タクロウ
v33=ヨシミ
z1r=ゼンイチロウ
z2r=ゼンジロウ
uej=ウエキ
uex=ウエノ
o2j=オオツキ
iuq=イノウエ
rw=クラ
bk=クロ
uf=ウエ
aoj=アオキ
cx=カミ
gw=マサカズ
a.=ア
i.=イ
u.=ウ
e.=エ
o.=オ
ga.=ガ
gi.=ギ
gu.=グ
ge.=ゲ
go.=ゴ
hb=ハシ
tab=タナベ
ttk=タカコ
fr=フル
bbk=ノブコ
jst=キシダ
nsp=ニシヤマ
brp=マルヤマ
zfx=マエノ
fam=ハタケ
;;コ
bck=マチコ
bjk=マキコ
blk=サキコ
bmk=マミコ
brk=マリコ
bsk=マスコ
byk=マユコ
cdk=チヅコ
cfk=カナコ
chk=チホコ
cqk=チエコ
csk=チサコ
cyk=チヨコ
czk=チズコ
cnk=カネコ
fjk=フジコ
fmk=ナミコ
fsk=フサコ
ftk=ナツコ
fzk=ナホコ
fnk=ナツコ
hdk=ヒデコ
hfk=ヒナコ
hjk=セイコ
hqk=ヒサコ
hsk=ヒサコ
hxk=ヒラコ
jlk=スミコ
jmk=キミコ
jqk=キエコ
kdk=ツギコ
kfk=ハナコ
kgk=ノリコ
kmk=クミコ
ktk=テルコ
kvk=カツコ
kyk=キョウコ
mbk=モトコ
mck=ミカコ
mhk=ミホコ
mjk=ミキコ
mlk=モエコ
mqk=ミエコ
msk=ミサコ
mtk=モトコ
myk=ミヤコ
mzk=ミホコ
mnk=ミネコ
qfk=エナコ
rck=リカコ
rhk=リュウコ
rmk=ルミコ
rqk=リエコ
rtk=リツコ
rxk=リンコ
rzk=リホコ
rnk=スズコ
sdk=サダコ
sgk=シゲコ
shk=シュウコ
sqk=サエコ
srk=サクラコ
svk=セイコ
swk=サワコ
sxk=サトコ
syk=ショウコ
szk=シズコ
tbk=タマコ
thk=タツコ
tjk=トキコ
tmk=トモコ
tqk=タエコ
tsk=トシコ
tyk=トヨコ
tkk=トクコ
wck=ワカコ
wkk=ワカコ
xsk=サトコ
yck=ユカコ
yhk=ヨウコ
yjk=ユキコ
ylk=ヨウコ
ymk=ユミコ
yqk=ヤエコ
yrk=ユリコ
ysk=ヤスコ
yxk=ヤスコ
ynk=ヨネコ
zkk=マツコ
cck=チカコ
ffk=フウコ
llk=ユイコ
mmk=モモコ
rrk=アキコ
yyk=ユウコ
kkk=キクコ
abk=アビコ
ajk=アキコ
alk=アヤコ
ask=アサコ
atk=アツコ
ayk=アユコ
ick=イチコ
itk=イツコ
ikk=イクコ
emk=エミコ
erk=エリコ
ndk=ナオコ
nlk=ナオコ
nqk=ヤエコ
gik=ヨシコ
kek=ケイコ
bik=マイコ
pok=クニコ
mek=ミエコ
yok=ヨウコ
rek=レイコ
1gk=ムツコ
3ck=ミカコ
3qk=ミエコ
3wk=ミワコ
3ek=ミエコ
8qk=ヤエコ
b8k=スズコ
c4k=カヨコ
cek=チエコ
d8k=タツコ
f2k=ナツコ
h2k=ハツコ
kqk=キヨコ
m2k=マツコ
m3k=ミツコ
m4k=ミヨコ
m8k=ミヤコ
s2k=セツコ
s4k=サヨコ
t8k=タキコ
e2k=エツコ
ket=ケイタ
sot=ソウタ
bod=イタ
mut=ムタ
8wt=ヤワタ
rwt=クラタ
cit=カマダ
h4t=ハラダ
kqt=キヨタ
t8t=タキタ
uut=ウエダ
oot=オオタ
;;タ
bct=マチダ
bjt=マキタ
bkt=クロダ
brt=クマダ
brq=マルタ
bst=マスダ
cht=チダ
cjt=カジタ
ckt=タケダ
cst=タケシタ
cxt=カンダ
cyt=チヨダ
cnt=カネダ
dct=ツチダ
dgt=ヤマガタ
dst=ヤマシタ
fct=フカダ
fjt=フジタ
fkt=フクダ
frt=フルタ
fst=フカダ
fnt=フナダ
hft=ヒナタ
hjt=セイタ
hlt=ハンダ
hmt=ハマダ
hrt=ヒルタ
hxt=ヒラタ
hzt=ハヤタ
hnt=ホンダ
jlt=スミダ
jlw=キノシタ
kbt=クボタ
kft=ハナダ
kht=コウタ
kmt=カメダ
krt=クラタ
kvt=カツタ
kwt=カワダ
ldt=ヨコタ
mft=モリタ
mkt=クワタ
mrt=ムラタ
mst=マスダ
myt=ミヤタ
mzt=ミズタ
mnt=ミネタ
rht=リュウタ
rnt=ハヤシダ
sbt=シバタ
sct=サカタ
sft=サナダ
dht=スギタ
sht=シュウタ
slt=シオダ
smt=シマダ
srt=サクラダ
sxt=シノダ
yot=ショウダ
syt=ショウタ
szt=サワダ
tfm=タバタ
tjt=トキタ
tkt=トクダ
flt=トモダ
tmt=トミタ
tpt=テラダ
tyt=トヨダ
vsd=ヨシサダ
wjt=ワキタ
wnt=フウタ
xnt=オノダ
ygt=ヤナギダ
yht=ヨウタ
dt=ヤマダ
yst=ヤスダ
ynt=ヨネダ
zft=マエダ
zst=マツシタ
fft=キタダ
ggt=ナガタ
kkt=キクタ
mmt=モモタ
sst=シュンタ
yyt=ユウタ
zzt=サワダ
ttt=タカダ
ajt=アキタ
art=アリタ
ast=アサダ
ift=イナダ
ikt=イケダ
ist=イシダ
iwt=イワタ
uct=ウチダ
ujt=ウキタ
umt=ウメダ
urt=ウラタ
eht=エイタ
obt=オバタ
oct=オカダ
ogt=オガタ
oht=オオハタ
ojt=オキタ
okt=オクダ
ost=オサダ
olw=オオシタ
nbt=ヌマタ
nct=イマダ
njt=ナリタ
nkt=ナカダ
nmt=ヌマタ
nst=ニシダ
ntt=ニッタ
;;オ
gil=ヨシオ
pol=クニオ
1gl=ムツオ
f2l=ナツオ
h2l=ハツオ
m3l=ミツオ
s2l=セツオ
t8l=タキオ
e2l=エツオ
brl=マルオ
bsl=マスオ
bll=サキオ
cml=カミオ
cnl=カネオ
fcl=フカオ
fgl=ナガオ
fjl=フジオ
fkl=フクオ
frl=タダオ
fsl=フサオ
fnl=ナツオ
hdl=ヒデオ
hql=ヒサオ
hxl=ヒラオ
hyl=ハヤオ
hzl=ハヤオ
hnl=ヒロナオ
jml=キミオ
jll=スミオ
kdl=ツギオ
kgl=ノリオ
ktl=テルオ
kvl=カツオ
ldl=ヨコオ
mcl=ミチオ
mfl=モリオ
mjl=ミキオ
mrl=ムラオ
msl=ミサオ
mtl=モトオ
myl=ミヤオ
mnl=モトオ
rfl=アラオ
sdl=サダオ
sgl=シゲオ
sxl=セノオ
szl=シズオ
tbl=タマオ
tdl=タダオ
thl=タツオ
tjl=トキオ
tkl=タクオ
tml=トモオ
tpl=テラオ
trl=テラオ
tsl=トシオ
tyl=トヨオ
vnl=ヨシナオ
wcl=ワカオ
yjl=ユキオ
ykl=ヨコオ
ysl=ヤスオ
yxl=ヤスオ
bbl=ノブオ
ffl=キタオ
ggl=ナガオ
jjl=ツギオ
kkl=キクオ
rrl=アキオ
ttl=タカオ
asl=アサオ
atl=アツオ
ikl=イクオ
isl=イサオ
iwl=イワオ
esl=テツオ
osl=オシオ
nkl=ナカオ
nsl=ニシオ
lw=シタ
;;以下未加工
bdc=マドカ
bf8=マナト
bfb=マナブ
bfc=マナカ
bfm=マナミ
bhc=タケヒコ
bj8=マキト
bjc=マキウチ
bjd=マキヤマ
bjl=マスミ
bjq=マキエ
bjs=マキセ
bjx=マキノ
bkd=クロヤマ
bkj=クロキ
bkm=シオリ
bkq=クロエ
bks=クロサキ
bkw=タケカワ
bld=サキヤマ
blq=サキエ
blx=サキノ
blz=サキホ
bmv=クマガイ
bmx=クマノ
bmz=クマザキ
brc=マリカ
brd=マルヤマ
brf=マリナ
brm=マルモト
brs=ミサト
brx=マリン
bsd=マスヤマ
bsj=クボキ
bsm=マスモト
bsr=マシロ
btj=マツキ
byc=マユカ
bym=マユミ
bys=バヤシ
bnm=マナミ
cbl=チサキ
cbm=カマモト
cdr=チヅル
cf2=チナツ
cf4=カナヨ
cf8=カナト
cfd=カナヤマ
cfj=キンジョウ
cfm=カナモト
cfq=カナエ
cfy=カナヤ
cgm=タケガミ
cgw=カガワ
ch4=チハラ
chc=タケヒコ
chq=タケヒサ
chx=チノ
chy=チハヤ
chz=チホ
cjd=カジヤマ
cjl=カスミ
cjm=カジモト
cjx=カジノ
ck3=タケゾウ
ck4=タケヨ
ckb=タケベ
ckc=タケウチ
ckd=タケヤマ
ckf=タケフミ
ckh=タケヒロ
ckm=タケモト
ckp=タケハル
ckw=タケカワ
ckx=タケノ
cky=タケユキ
ckz=タケザキ
ckn=タケヤ
cmd=カミヤマ
cmt=タケモト
cqm=チエミ
crs=チサト
crx=カリン
csm=タケシマ
csp=チハル
csz=タケサワ
ctd=カタヤマ
ctr=カツラ
cts=チトセ
ctx=カタノ
cx8=カント
cxd=カミヤマ
cxf=カンナ
cxs=チサト
cxy=カミヤ
cxz=カンザキ
cym=チヨミ
cxx=カノン
cn8=カネト
cnd=カネヤマ
cnm=カネモト
cns=タケナリ
cnv=カネヨシ
cny=カネユキ
dbc=ダイチ
dbj=ヤマブキ
dcm=ツチモト
dcn=ツチヤ
dfs=ヤマナシ
dgc=デグチ
dgm=ヤマガミ
dgs=ヤマギシ
dgw=ヤマギワ
dhx=ヤマヒラ
djr=ダイジロウ
djs=ヤマギシ
dk1=タイチ
dkr=ヤマクラ
dkw=ヤマカワ
dmf=ヤマモリ
dmr=ヤマムラ
dr8=ユメト
drc=ユメカ
drf=ユメナ
drx=ユメノ
drz=ユメホ
drn=ヤマバヤシ
dsf=ヤマシナ
dsk=ダイスケ
dsr=ヤマシロ
dwj=ヤマワキ
dxc=ヤマノウチ
dff=ヤマキタ
dkk=タカギ
drr=ヤマナシ
dtt=ヤマタカ
dzz=ヤマザワ
dnk=ヤマナカ
dnm=ヤマナミ
dnr=ヤマネ
dns=ヤマニシ
fcm=ナカモト
fcs=フカセ
fci=ナカイ
fcn=フカヤ
fgj=ナガキ
fgq=ナガエ
fgs=ナギサ
fgt=ナツキ
fh8=フミヒト
fhc=フミヒコ
fhq=フミヒサ
fjd=フジヤマ
fjm=フジモト
fje=フジエ
fjs=フジサキ
fjv=フジヨシ
fjx=フジノ
fjz=フジマツ
fjn=フジヤ
fk4=フクヨ
fkc=フクチ
fkd=フクヤマ
fkg=フミノリ
fkm=フクモト
fkz=フクザキ
fl3=トモゾウ
fmj=ナミキ
fmq=ナミエ
fmw=フミカズ
frc=フルウチ
frd=フルヤマ
frf=タダフミ
frh=タダヒロ
frm=フルモト
frp=タダハル
frv=タダヨシ
frw=タダカズ
frx=フルノ
fry=タダユキ
frn=フルヤ
fs4=フサヨ
fsd=フカヤマ
fsq=フサエ
fsv=フカヤ
fsx=フカノ
fsn=フカヤ
ftq=ナツエ
fts=フミトシ
fwg=フウガ
fwv=ナナミ
fys=フミヤス
fyx=フミヤス
fzm=ナホミ
fbb=フミノブ
fjj=フジキ
fkk=フクオカ
frr=フミアキ
fss=フカセ
ftt=フミタカ
fn4=ナツヨ
fnj=ナツキ
fnm=ナツミ
fnq=ナツエ
fns=フミナリ
fnz=ナツホ
gh8=マサヒト
ghc=マサヒコ
ghd=マサヒデ
ghq=マサヒサ
ght=マサヒト
gk8=ガクト
gkd=マサツグ
gkg=マサノリ
gkt=マサテル
gkv=マサカツ
glf=ミゾ
glg=ミゾグチ
gm3=マサミツ
gmc=マサミチ
gmf=マサムネ
gmp=マサハル
gsg=マサシゲ
gtm=マサトモ
gts=マサトシ
gtx=ツキノ
gty=ツキヤマ
gys=マサヤス
gbb=マサノブ
gcc=マサチカ
gjj=マサツグ
gmm=マサミ
gpp=マサハル
grr=マサアキ
gtt=マサタカ
gnd=マサナオ
gnj=ゲンキ
hbt=ハシダ
hbg=ハシグチ
hbj=ヒビキ
hbm=ハシモト
hbr=ヒマリ
hbs=ハマサキ
hbx=ハシノ
hbz=ハマザキ
hck=ヒロタケ
hcr=ヒカリ
hci=フカイ
hd2=ヒデジ
hd4=ヒデヨ
hd8=ヒデト
hdf=ヒデフミ
hdg=ヒデマサ
hdh=ヒデヒロ
hdj=ヒデキ
hdm=ヒデミ
hdp=ヒデハル
hdv=ヒデヨシ
hdw=ヒデカズ
hdy=ヒデユキ
hdn=ヒデヤ
hfr=ヒロタダ
hfx=ヒナノ
hgm=ハギモト
hgs=ヒガシ
hj1=セイイチ
hj2=セイジ
hj5=セイゴ
hj8=セイト
hjb=セイマ
hjf=セイナ
hjm=ハジメ
hjs=セイシ
hjx=セイノ
hjn=セイヤ
hkd=ヒロツグ
hkg=ヒロノリ
hkv=ヒロカツ
hkw=ヒロカワ
hm3=ヒロミツ
hmc=ヒロミチ
hmg=ハマグチ
hmr=ヒマリ
hms=ハマサキ
hmx=ハマノ
hmz=ハマザキ
hq1=ヒサイチ
hq4=ヒサヨ
hq8=ヒサト
hqt=ヒサダ
hqm=ヒサモト
hqp=ヒサハル
hqq=ヒサエ
hqs=ヒサシ
hqv=ヒサヨシ
hqw=ヒサカズ
hqx=ヒサノ
hqy=ヒサユキ
hqz=ヒサマツ
hqe=ヒサエ
hqo=ヒサオ
hqn=ヒサヤ
hrb=ホリベ
hrc=ホリウチ
hrq=ホリエ
h4x=ハラノ
hsb=ハセベ
hsg=ハセガワ
hsm=ヒロシマ
hsx=ホシノ
hsy=ヒサユキ
hsz=ヒロサワ
hsn=ホシノ
ht4=ハツヨ
htd=ハタケヤマ
hth=ホソ
htm=ヒトミ
htq=ハツエ
hts=ヒロトシ
htv=ヒロタニ
htx=ハタノ
hty=ハタケヤマ
htn=ハタナカ
hxb=ヒラマ
hxc=ヒラウチ
hxd=ヒラヤマ
hxj=ヒラキ
hxm=ヒラモト
hxs=ヒラセ
hxy=ヒラヤマ
hxz=ヒラマツ
hy8=ハヤト
hyr=ヒヨリ
hys=ヒロヤス
hyx=ヒロヤス
hz8=ハヤト
hzb=ハザマ
hzs=ハヤサキ
hbb=ヒロノブ
hdd=ヒダカ
hmm=ハマモト
hrr=ヒロアキ
hss=ヒサシ
htt=ヒロタカ
hxx=ヒラノ
hzz=ヒロサワ
hnb=ホンマ
hnj=ホンジョウ
hnk=ヒロナカ
hnm=ホンマ
hns=ヒロナリ
hnz=ホンマツ
jgc=キグチ
jh2=ジョウジ
jh4=キハラ
jhj=ジュンセイ
jl4=スミヨ
jlc=スミカ
jlq=スミエ
jlr=スミレ
jlv=スミヨシ
jlx=スミノ
jln=スミヤ
jm4=キミヨ
jmc=キミカ
jmh=キミヒロ
jmj=キミジマ
jmp=キミハル
jmq=キミエ
jmr=キムラ
jmv=キミヨシ
jny=ジュンヤ
jrd=キリヤマ
jsd=キシヤマ
jsm=キシモト
jsv=ジュンセイ
jsx=キシノ
jtr=ジョウタロウ
jx1=ジンイチ
jxn=ジンノ
jn2=ジュンジ
jnf=ジュンナ
kbj=クマキ
kbm=クマモト
kbz=クマザキ
kdb=コダマ
kdm=コダマ
kdr=コデラ
kf2=コナツ
kf4=ハナヨ
kfc=ハナカ
kfm=ハナモト
kfq=ハナエ
kfs=ハナサキ
kfw=ハナワ
kfx=ハナノ
kfn=コナツ
kg8=ノリト
kgc=ノリカ
kgd=カゲヤマ
kgf=ノリフミ
kgh=ノリヒロ
kgq=ノリエ
kgv=ノリヨシ
kgw=ノリカズ
kgy=ノリユキ
kh1=コウイチ
kh2=コウジ
kh3=コウゾウ
kh4=コハラ
kh8=ケイト
khd=コウダイ
khg=コウガ
khj=コウキ
khr=コウラ
khx=コウノ
khn=コウヤ
kjc=ケンキチ
kjm=コジマ
kjr=ケンジロウ
kn2=カンジ
kmf=コモリ
knt=カンタ
kmn=コミネ
kmr=コムラ
kmy=コミヤ
kqp=キヨハル
kr2=カオル
kr3=クルミ
krj=クロキ
krm=クラモト
krq=クロエ
krs=クロサキ
krn=コバヤシ
ksc=コサカ
ksg=コスギ
ksj=コセキ
ksk=ケンスケ
ksp=コハル
ksv=ケンセイ
ksw=カシワバラ
ksx=クサノ
kt4=テルヨ
ktb=テルマ
ktf=テルフミ
ktg=テルマサ
kth=テルヒロ
ktj=テルキ
ktm=テルミ
ktp=コデラ
ktq=テルエ
ktr=ケンタロウ
ktv=テルヨシ
ktw=テルカズ
kty=テルユキ
ktn=テルヤ
kv1=カツイチ
kv2=カツジ
kv3=カツゾウ
kv4=カツヨ
kv8=カツト
kvb=カツマ
kvd=カツヤマ
kvf=カツフミ
kvg=カツマサ
kvh=カツヒロ
kvj=カツキ
kvm=カツミ
kvp=カツハル
kvq=カツエ
kvr=カツロウ
kvx=カツノ
kvy=カツユキ
kvn=カツヤ
kwb=カワベ
kwc=カワウチ
kwf=カワナ
kwg=カワグチ
kwj=カワキ
kwm=カワモト
kwq=カワゴエ
kwr=カワラ
kws=カワサキ
kwv=カワタニ
kwx=カワノ
kwz=カワマツ
kxc=コノカ
kxg=コグチ
knh=カノウ
kxj=コユキ
kxp=コハル
kxs=ケンシン
kxy=コユキ
kxz=コマツ
kxn=ケンヤ
ky1=キョウイチ
ky2=キョウジ
ky5=キョウゴ
kyc=キョウカ
kyg=コヤナギ
kyj=コユキ
kyn=キョウヤ
kzb=カザマ
kzq=コズエ
kgg=ノリマサ
krr=キララ
kvv=カツヨシ
kyy=キョウ
kng=ケンゴ
knm=カナメ
knp=コンドウ
kns=コニシ
lbg=ヤグチ
lbj=ヤブキ
lbx=ヤノ
lbz=ヤザキ
ldc=ヨコウチ
ldh=ヨコハマ
ldq=ヨコエ
ldx=ヨコノ
ldz=ヨコマツ
lbb=ヤベ
ldd=ヨコヤマ
mb8=ミスズ
mbh=モトヒロ
mbl=ミサキ
mby=モトユキ
mcg=ミチマサ
mch=ミチヒロ
mcp=ミチハル
mcq=ミチエ
mcr=ミチル
mcy=ミチヨ
mci=ムカイ
mce=ミチエ
mcn=ミチヤ
mdh=ミヅホ
mdj=ミヅキ
mdr=ミドリ
mf8=ミナト
mfb=マナブ
mfd=モリヤマ
mfg=モリグチ
mfh=モリヒロ
mfm=モリモト
mfs=モリサキ
mfv=モリタニ
mfy=モリユキ
mfn=モリヤ
mgm=メグミ
mgr=メグロ
mgt=モチヅキ
mj8=ミキト
mjx=マキノ
mjn=ミキヤ
mkd=クワヤマ
mkf=クワナ
mkm=ミカミ
mkx=クワノ
mkz=クワザキ
mlc=モエカ
mlt=カケル
mlx=モエノ
mln=シオン
mpn=シオン
mrd=ムラヤマ
mrj=ムラキ
mrm=ムラモト
mrq=ムラコシ
mrs=ムラセ
mrx=ムラノ
mrz=ムラマツ
ms4=ミサヨ
ms8=ミサト
msj=ミサキ
msq=ミサエ
msw=マサカズ
mtd=モトヤマ
mtf=モトフミ
mth=モトヒロ
mtj=モトキ
mtm=マツモト
mtq=マツエ
mts=マツサキ
mtx=マツノ
mty=モトユキ
mtz=マツザキ
mtn=モトヤ
mx2=ミノル
mxr=ミノリ
myb=マユミ
myc=ミヤウチ
myg=ミヤギ
myj=ミヤギ
mym=ミヤモト
myx=ミヤノ
myz=ミヤザキ
mzc=ミズウチ
mzg=ミズグチ
mzj=ミズキ
mzm=ミズモト
mzq=ミズエ
mzv=ミズタニ
mzx=ミズノ
mzz=ミズホ
mn2=ミノル
mnb=マナブ
mnr=ミノリ
pfm=ハルフミ
phc=ハルヒコ
phd=ハルヒデ
phq=ハルヒサ
pht=ハルヒト
pkg=ハルノリ
pkw=ハルカワ
pm3=ハルミツ
pmc=ハルミチ
psg=ハルシゲ
pts=ハルトシ
pd=ハルヤマ
pyx=ハルヤス
pbb=ハルノブ
prr=ハルアキ
ptt=ハルタカ
rc5=リョウゴ
rcb=リョウマ
rcg=リョウガ
rcn=リョウヤ
rfd=アラヤマ
rfj=アラキ
rh1=リュウイチ
rh2=リュウジ
rh3=リュウゾウ
rh5=リュウゴ
rh8=リュウト
rhb=リュウマ
rhc=アキヒコ
rhg=リュウガ
rhj=リュウキ
rhx=リョウヘイ
rhz=リュウザキ
rhn=リュウヤ
rjr=リョウジロウ
rk8=リクト
rln=レオン
rpn=リオン
rsb=サトミ
rsk=リョウスケ
rsv=リョウセイ
rtr=リョウタロウ
rx8=リント
rxc=リンカ
rxf=リンナ
ryc=リョウカ
ryn=リョウヤ
rtt=ツチヤ
rnf=スズナ
rnh=スズハ
rnx=スズノ
rnz=ハヤシザキ
sbd=シバヤマ
sbm=シバモト
sbr=スバル
sbs=シバサキ
sbx=シバノ
sby=シブヤ
sbz=シバザキ
sbn=シブヤ
sc4=サチヨ
scb=シカマ
scg=サカグチ
scj=サカキ
scm=サカモト
scq=サカエ
scx=サカノ
scy=サチヨ
scz=サカザキ
sci=サカイ
sce=サチエ
scn=ツチヤ
sd1=サダイチ
sd4=サダヨ
sdh=サダヒロ
sdp=サダハル
sdq=サダエ
sdv=サダヨシ
sdw=サダカズ
sdy=サダユキ
sdz=サダマツ
sfq=サナエ
sg1=シゲイチ
sg2=シゲジ
sg3=シゲミ
sg4=シゲヨ
sg8=シゲト
sgf=シゲフミ
sgh=シゲヒロ
sgj=シゲキ
sgp=シゲハル
sgr=サガラ
sgs=スギサキ
sgv=シゲヨシ
sgw=シゲカズ
sgy=シゲユキ
sgz=シゲマツ
sgn=スガヤ
sh1=シュウイチ
sh2=シュウジ
sh3=シュウゾウ
sh5=シュウゴ
sh8=シュウト
shb=シュウマ
shj=シュウキ
shp=シュトウ
shn=シュウヤ
sjc=セキウチ
sjd=スギヤマ
sjg=セキグチ
sjm=スギモト
sjq=スギエ
sjs=シンジョウ
sjx=スギノ
sjy=セキヤ
sjn=セキネ
skm=サクマ
skn=サクヤ
slc=サヤカ
sld=サヤマ
slm=シオミ
slr=サオリ
slx=シオノ
slz=シオザキ
sln=シオヤ
smc=シマウチ
smr=シムラ
sms=シマサキ
smx=シマノ
smz=シマザキ
smn=シマヤ
sny=シンヤ
sqc=サエカ
sqj=サエキ
srb=サクラバ
srf=セリナ
srg=サクラギ
srj=シラキ
srs=シラサキ
stf=ショクイン
str=シンタロウ
sty=テツユキ
sv1=セイイチ
sv2=セイジ
sv3=セイゾウ
sv5=セイゴ
svb=セイマ
svf=セイナ
svj=セイキ
svx=セイノ
svn=セイヤ
sx4=シノハラ
sxd=シノヤマ
sxf=サトフミ
sxm=サトミ
sxp=シンドウ
sxq=サトエ
sxs=シノサキ
sxz=シノザキ
sxn=シンヤ
sy1=ショウイチ
sy2=ショウジ
sy3=ショウゾウ
sy5=ショウゴ
sy8=ショウト
syb=ショウマ
syg=ショウゴ
syj=ショウキ
syp=ストウ
syr=サユリ
syn=ショウヤ
sz4=シズヨ
szc=シズカ
szg=サワグチ
szj=サワキ
szm=サワモト
szq=シズエ
szx=サワノ
szn=サワノ
sbb=シノブ
sgg=シゲ
skk=ツカサ
sll=サカ
smm=シマモト
spp=シンペイ
sn1=シンイチ
sn2=シンジ
snb=シノブ
snc=サヤカ
sng=シンゴ
snh=シノハラ
snp=シンドウ
tbc=タブチ
tbt=タマダ
tbj=タマキ
tbm=タマミ
tbq=タマエ
tbr=タマル
tbs=ツバサ
tbx=タマノ
tcb=タチバナ
t3t=ツカダ
tcm=ツカモト
tcy=ツチヤ
td3=トヅカ
tdc=テヅカ
tdr=トドロキ
tds=タダシ
tdv=タダヨシ
tdy=タシロ
tfb=タナベ
tgc=タグチ
tgs=トガシ
tgw=タガワ
th2=タツジ
th4=タハラ
thb=トウマ
thd=トオヤマ
thj=タツキ
thm=タツミ
thq=タツエ
thr=タツロウ
tht=タツヤ
thv=タツヨシ
thx=タツノ
thy=タツユキ
thn=タツヤ
tjb=タジマ
tjg=タキグチ
tjm=タジマ
tjq=トキエ
tjn=トキヤ
tk2=タクム
tk8=タクト
tkb=タクマ
tkd=トクヤマ
tkm=タクミ
tkr=タケル
tks=タカセ
tky=タカユキ
tkn=タクヤ
tm2=トモジ
tm4=トモヨ
tmc=トモカ
tmt=トモダ
tmf=トモフミ
tmg=トモマサ
tmh=トモヒロ
tmj=トモキ
tmp=トモハル
tmq=トモエ
tmr=タムラ
tmv=トモヨシ
tmw=トモカズ
tmx=トモノ
tmy=トモユキ
tmn=トモヤ
tpc=テラウチ
tpd=テラヤマ
tpm=テラモト
tps=テラサキ
tr3=テルミ
trd=テラヤマ
trg=テラグチ
trq=テルエ
trs=テラサキ
trx=テラノ
ts1=トシイチ
ts2=トシジ
ts3=トシゾウ
tsc=タサカ
tsf=トシフミ
tsg=トシマサ
tsj=トシキ
tsp=トシハル
tsq=トシエ
tsw=トシカズ
tsy=トシユキ
tsn=トシヤ
tvc=タニウチ
tvd=タニヤマ
tvg=タニグチ
tvm=タニモト
tvz=タニザキ
tx2=タンジ
kat=ツノダ
txj=タンジ
txn=タンノ
ty2=トヨジ
tyh=トヨヒロ
tyj=トヨキ
typ=トヨハル
tys=トヨサキ
tyw=トヨカズ
tzk=タザキ
tcc=タチバナ
thh=タツヒロ
tmm=トモミ
tpp=テッペイ
tzz=タザワ
tnb=タナベ
tnc=タニウチ
tnd=タヤマ
tng=タニグチ
tnm=タヌマ
tns=タニサキ
tnz=タニザキ
vck=ヨシタケ
vcn=ヨシカネ
vfr=ヨシタダ
vfs=ヨシフサ
vh4=ヨシハラ
vh8=ヨシヒト
vhb=ヨシハシ
vhc=ヨシヒコ
vhd=ヨシヒデ
vhq=ヨシヒサ
vht=ヨシヒト
vjc=ヨシキチ
vjl=ヨシズミ
vkd=ヨシツグ
vkg=ヨシノリ
vkt=ヨシテル
vkv=ヨシカツ
vkw=ヨシカワ
vm3=ヨシミツ
vmc=ヨシミチ
vmf=ヨシモリ
vmr=ヨシムラ
vmt=ヨシマツ
vmn=ヨシムネ
vsg=ヨシシゲ
vtb=ヨシトモ
vtm=ヨシトモ
vts=ヨシトシ
vwr=ヨシワラ
vd=ヨシヤマ
vys=ヨシヤス
vyx=ヨシヤス
vbb=ヨシノブ
vcc=ヨシチカ
vgg=ヨシナガ
vjj=ヨシツグ
vrr=ヨシアキ
vtt=ヨシタカ
vzz=ヨシザワ
vnd=ヨシナオ
vnj=ヨシナリ
vnk=ヨシナカ
wby=ワカバヤシ
wc8=ワカト
wcb=ワカバ
wcd=ワカヤマ
wcf=ワカナ
wcj=ワカキ
wcm=ワカモト
wcz=ワカマツ
wci=ワカイ
wgt=ハネダ
whc=カズヒコ
whd=カズヒデ
whq=カズヒサ
wht=カズヒト
wjd=ワキヤマ
wjm=ワキモト
wkq=カズキヨ
wk8=ワカト
wkb=ワカバ
wkd=ワカヤマ
wkf=ワカナ
wkg=カズノリ
wl8=カズネ
wsg=カズシゲ
wtb=ワタベ
wtj=ワタナベ ジュン
wtm=カズトモ
wtr=ワタル
wts=カズトシ
wys=カズヤス
wbb=カズノブ
wrr=カズアキ
wtt=カズタカ
wn8=フウト
wnb=フウマ
wnc=フウカ
wnd=カズナオ
wng=ツバサ
wnj=カズナリ
xdc=ノドカ
xgw=ノガワ
xh4=ノハラ
xhr=ノハラ
xjm=ノジマ
xmr=ノムラ
xmy=ノミヤ
xsf=サトフミ
xsm=サトミ
xsq=サトエ
xsr=サトル
xzz=ノザワ
xnk=ノナカ
xnp=オノデラ
xnz=オノザキ
ybc=ヤブウチ
ybj=ヤブキ
ycr=ユカリ
ycy=ヤチヨ
ydj=ユヅキ
yfs=ヤナセ
ygb=ヤナギバ
ygc=ヤギウチ
ygm=ヤナギモト
ygs=ヤナギサワ
yh1=ヨウイチ
yh2=ヨウジ
yhc=ユキヒコ
yhd=ユキヒデ
yhq=ユキヒサ
yhx=ヨウヘイ
yj4=ユキヨ
yj8=ユキト
yjf=ユキナ
yjg=ユキマサ
yjh=ユキヒロ
yjp=ユキハル
yjq=ユキエ
yjv=ユキヨシ
yjw=ユキカズ
yjx=ユキノ
yjz=ユキホ
yjn=ユキヤ
ykc=ヨコウチ
ykd=ヨコヤマ
ykg=ユキノリ
ykt=ユキテル
yky=ヨコヤマ
ykn=ユキナ
yl2=ユウジ
ym8=ヤマト
ymb=ヤマベ
ymc=ヤマウチ
ymt=ヤマダ
ymg=ヤマグチ
ymj=ヤマキ
ymq=ユミエ
yms=ヤマサキ
ymz=ヤマザキ
ymn=ヤマネ
yrc=ユリカ
yrf=ユリナ
yrq=ユリエ
ys2=ヤスジ
ys4=ヤスヨ
ys8=ヤスト
ysb=ヤシマ
ysc=ヤスカ
ysf=ヤスフミ
ysg=ヤスマサ
ysh=ヤスヒロ
ysm=ヤスモト
ysp=ヤスハル
ysq=ヤスエ
ysv=ヤスヨシ
ysw=ヤスカズ
ysx=ヤスノ
ysy=ヤスユキ
ysn=ヨシノ
ytk=ユタカ
yx2=ヤスジ
yx3=ヤスゾウ
yx4=ヤスヨ
yx8=ヤスト
yxd=ヤスダ
yxf=ヤスフミ
yxh=ヤスヒロ
yxj=ヤスキ
yxm=ヤスモト
yxp=ヤスハル
yxq=ヤスエ
yxw=ヤスカズ
yxy=ヤスユキ
yzc=ユズカ
yzj=ユズキ
yzk=ヤザキ
yzw=ヤザワ
ybb=ユキノブ
ymm=ヤマモト
ytt=ユキタカ
yxx=ヤスノ
yzz=ユザワ
ynd=ヨネヤマ
ynj=ユキナリ
ynm=ヨネモト
yns=ヤナセ
zbr=マツバラ
zdy=マツシロ
zfd=マエヤマ
zfj=マツフジ
zfy=マエヤマ
zh4=マツハラ
zhb=マツハシ
zkf=マツハナ
zkr=マツクラ
zkw=マツカワ
zkz=マツザキ
zmr=マツムラ
zmy=マツミヤ
zrn=マツバヤシ
zsc=マツサカ
zsk=マツサキ
zsm=マツシマ
ztd=マツド
ztv=マツタニ
ztn=マツタニ
zwv=マツナミ
zx2=ゼンジ
zxc=ホノカ
zgg=マツナガ
znk=マツナカ
znm=マツヌマ
bb4=ノブヨ
bb8=ミスズ
bbc=マブチ
bbg=ノブマサ
bbh=ノブヒロ
bbp=ノブハル
bbq=ノブエ
bbv=ノブヨシ
bbw=ノブカズ
bby=ノブユキ
bbn=ノブヤ
ccl=マドカ
dd8=ヤマト
ddj=タカギ
ddk=タカギ
ff8=ホクト
ffb=フウマ
ffd=キタヤマ
ffg=キタグチ
ffj=フウキ
ffm=キタモト
ffs=キタサキ
ffx=キタノ
ffz=キタザキ
ffn=キタヤ
ggd=ナガヤマ
ggj=ナガキ
gge=ナガエ
ggs=ナガサキ
ggv=ナガヨシ
ggx=ナガノ
ggy=ナガヤマ
ggz=ナガマツ
ggn=ナガヤ
hhc=ヒロヒコ
hhd=ヒロヒデ
hhq=ヒロヒサ
hht=ヒロヒト
hhx=ヒロノ
jj2=ジョウジ
jjm=キジマ
jjv=ツグヨシ
kk4=キクヨ
kk8=ココネ
kkc=キクチ
kkf=ココナ
kkh=ココハ
kkm=ココミ
kkp=コンドウ
kkq=キクエ
kkr=ココロ
kkn=ココネ
ll8=ユイト
llc=ユイカ
llf=ユイナ
llx=ユイノ
mm4=モモヨ
mm8=カイト
mmc=モモカ
mmf=モモナ
mmq=モモエ
mmr=マモル
mms=モモセ
mmx=ウンノ
mmz=シミズ
rr4=アキヨ
rr8=アキト
rrc=リリカ
rrf=アキフミ
rrg=アキマサ
rrh=アキヒロ
rrp=アキハル
rrq=アキエ
rrv=アキヨシ
rrw=アキカズ
rrx=アキノ
rry=アキユキ
rrz=アキホ
rrn=バヤシ
ss1=シュンイチ
ss2=シュンジ
ss5=シュンゴ
ss8=シュント
ssd=シシド
ssj=シュンキ
ssm=ススム
ssp=シュンペイ
ssq=サカエ
ssn=シュンヤ
tt2=タカツ
tt3=テツカ
tt4=タカヨ
tt8=タカト
ttb=タチバナ
ttc=タカウチ
ttd=タカヤマ
ttf=タカフミ
ttg=タカマサ
tth=タカヒロ
ttj=タカキ
ttm=タカモト
ttp=タカハル
ttq=タカエ
tts=タカサキ
ttv=タカヨシ
ttw=タカカズ
ttx=タカノ
tty=タカユキ
ttz=タカマツ
ttn=タカヤ
vvm=ヨシミ
xxc=ノノカ
xxd=ノノヤマ
yy1=ユウイチ
yy2=ユウジ
yy3=ユウゾウ
yy5=ユウゴ
yy8=ユウト
yyb=ユウマ
yyc=ユウカ
yyd=ユウダイ
yyf=ユウナ
yyg=ユウガ
yyh=ユウヒ
yyj=ユウキ
yym=ユウミ
yyr=ユウリ
yyn=ユウヤ
zzc=マツザカ
zzd=サワヤマ
zzf=マツマエ
zzg=サワグチ
zzk=マツザキ
zzm=サワモト
zzx=サワノ
bbb=マナブ
mmm=マナブ
zzz=マツザワ
abx=アマノ
abn=アマネ
acr=アカリ
aci=アカイ
kaf=アカネ
ad2=アカツ
ad3=アカツカ
adb=アカマ
adc=アダチ
adj=アカギ
adz=アカマツ
aj8=アキト
ajb=アキバ
ajd=アキヤマ
ajf=アキナ
ajm=アキモト
ajv=アキヨシ
ajx=アキノ
ajz=アキホ
akm=アケミ
aky=アキヤマ
al8=アヤト
alc=アヤカ
alf=アヤナ
alm=アヤミ
alx=アヤノ
aln=アヤネ
ar9=アライ
arb=アリマ
ard=アリヤマ
arg=アリガ
arm=アリモト
ars=アリサ
arz=アリマツ
arn=アラヤ
as4=アサヨ
asb=アスマ
asc=アスカ
asf=アスナ
asg=アサヒ
asm=アサミ
asr=アサクラ
asx=アサノ
asn=アサヤ
ath=アツヒロ
atj=アツキ
tic=アツミ
atr=アツロウ
aty=アツユキ
atn=アツヤ
awx=アワノ
axf=アンナ
axj=アンジュ
axr=アンリ
axs=アンズ
axz=アンザイ
ay2=アユム
ayf=アユナ
ayj=アユキ
aym=アユミ
ays=アヤセ
azm=アズミ
azs=アズサ
all=アヤノ
anz=アンザイ
ibj=イブキ
icb=イチバ
icd=イチヤマ
icx=イチノ
idc=イイヅカ
idm=イヅミ
ifb=イナバ
ifd=イナヤマ
ifg=イナガキ
ifm=イナモト
igc=イグチ
igw=イガワ
ihr=イハラ
ijm=イイジマ
ik4=イクヨ
ik8=イクト
ikb=イケベ
ikc=イケウチ
ikd=イケヤマ
ikm=イケモト
ikq=イクエ
ikr=イカラシ
ikx=イケノ
imr=イムラ
is2=イサム
is3=イサミ
isd=イシヤマ
isg=イシグチ
isk=イシカワ
ism=イシモト
isx=イシノ
isz=イシザキ
itj=イツキ
itr=イタル
iwb=イワマ
iwc=イワウチ
iwd=イワヤマ
iwf=イワナ
iwj=イワキ
iwm=イワモト
iws=イワサキ
iwx=イワノ
iwz=イワザキ
ixg=イノグチ
ixm=イノモト
iid=イイヤマ
ipp=イッペイ
izz=イザワ
inm=イイヌマ
ucd=ウチヤマ
ucm=ウチムラ
ucx=ウチノ
ujq=ウジイエ
umj=ウメキ
upc=ウエタケ
uqc=ウエタケ
uqy=ウエヤマ
uqz=ウエマツ
urb=ウラベ
urd=ウラヤマ
urm=ウラモト
urx=ウラノ
urz=ウラマツ
usm=ウサミ
utc=ウツノミヤセントラル
utm=ウツミ
umm=ウメモト
urr=ウララ
ebf=エビナ
egc=エグチ
egm=エモト
egp=エトウ
egs=エサキ
egw=エガワ
egz=エザキ
eh1=エイイチ
eh2=エイジ
eh3=エイゾウ
eh8=エイト
ejc=エイキチ
emc=エミカ
emr=エミリ
erc=エリカ
erf=エリナ
es2=テツジ
es8=テツト
esh=テツヒロ
esr=テツロウ
esn=テツヤ
etr=エイタロウ
etn=エツヤ
exm=エノモト
ess=テツシ
ezz=エザワ
enp=エンドウ
obc=オブチ
obm=オオクマ
obr=オバラ
ocb=オカベ
ocd=オカヤマ
ocj=オカジマ
ocm=オカモト
ocr=オカムラ
ocs=オカサキ
ocx=オカノ
ocz=オカザキ
oca=オチアイ
ocn=オカヤ
ofc=オオフチ
ogb=オグマ
ogc=オグチ
ogj=オオガキ
ogq=オオゴシ
ogr=オグラ
ogs=オガサワラ
ogw=オガワ
ogx=オギノ
oh4=オオハラ
ohm=オオハマ
ohr=オオホリ
ohx=オオヒラ
okb=オオクボ
okc=オオコウチ
okd=オクヤマ
okm=オクモト
okr=オオクラ
okw=オオカワ
okx=オクノ
olb=オオヤ
omc=オオミチ
omf=オオモリ
omr=オオムラ
omt=オオモト
omy=オオミヤ
omn=オオミネ
orq=オリエ
ors=オオサト
orn=オオバヤシ
os2=オサム
osk=オオサカ
osm=オオシマ
osr=オオシロ
osz=オオサワ
ot8=オオタキ
otb=オオツボ
otm=オオトモ
otv=オオタニ
owd=オオワダ
owj=オオワキ
oxd=オンダ
oyb=オオヤブ
oyg=オヤナギ
oym=オヤマ
ozf=オオマエ
ozj=オオゼキ
ozk=オザキ
odt=オヤマダ
ozz=オザワ
onj=オオヌキ
onm=オオヌマ
ons=オオニシ
nb8=ヤマト
nbj=ヤブキ
ncy=ヤチヨ
nd2=ナオジ
nd8=ナオト
ndc=ノドカ
ndf=ナオフミ
ndg=ナオマサ
ndh=ナオヒロ
ndj=ナオキ
ndm=ナオミ
ndp=ナオハル
ndq=ナオエ
ndv=ナオヨシ
ndy=ナオユキ
ndn=ナオヤ
ngc=ヤグチ
njm=ナルミ
njs=ネギシ
njy=ナリユキ
nkc=ナカウチ
nkj=ナカジマ
nkm=ナカモト
nkq=ナカエ
nks=ナカサキ
nky=ナカヤマ
nkz=ナカザキ
nkn=ナカヤ
nl8=ナオト
nlf=ナオフミ
nlh=ナオヒロ
nlj=ナオキ
nlm=ナオミ
nlq=ナオエ
nlv=ナオヨシ
nlw=ナオカズ
nln=ナオヤ
nmj=ナカムラ ジュン
nmr=ナカムラ
nsc=ニシウチ
nsd=ニシヤマ
nsg=ニシグチ
nsk=ノスケ
nsm=ニシモト
nsr=ヤシロ
nsx=ニシノ
nsz=ニシザキ
ntj=ナツキ
nwv=ナナミ
nz2=ノゾム
nss=ナルセ
nzz=ヤザワ
ix=イ
sok=ソウコ
fun=フネ
wr=ワラ
kin=キン
3hk=ミホコ
mn=モト
nil=ミネオ
ik3=イクミ
toy=トヨ
oo=オオ
hzk=ハヤカワ
suk=スケ
aik=アイコ
tub=ツボ
uft=ウエダ
ka4=カツラ
tuf=フサ
ew=エ
tmi=トミ
h7=ヒロユキ
dh=スギ
wap=ヌマ
har=ハットリ
yc=ユカ
inb=イノマタ
sck=サチコ
rj=ロウ
bas=バシ
mix=ミ
lx=オ
mok=クワ
nn=ノ
dy=シロ
nci=イマイ
ufx=ウエノ
jkk=キノシタ
whi=シライ
ahd=アオヤマ
3qv=ミエコ
htr=ハットリ
esk=テツコ
mx=ミツ
hd=ヒデ
kst=キノシタ
yhs=ヨウスケ
run=全問完了です！お疲れさまでした