1g=睦
2j=辻
rv=毅
3f=渉
3k=洸
3l=沙
3t=汰
3y=湧
7k=之
bc=渕
bd=部
bf=駿
bl=咲
bm=勉
br=丸
bs=隼
bt=端
bw=弓
bx=武
bn=敏
c8=籠
c9=篭
cf=金
ch=司
cj=梶
ck=竹
cl=澄
cr=知
cs=会
ct=片
cw=町
cx=神
cn=間
d8=龍
dd=大
dc=土
df=太
dk=徳
dn=第
dr=夢
dy=代
fub=吹
fc=淵
fd=吉
fg=凪
fj=藤
fk=福
fl=友
fm=文
fr=古
fs=深
fw=歩
fn=夏
gb=郷
gc=口
gd=剛
gj=垣
gk=学
gl=溝
gm=雅
gq=越
gt=月
gw=河
gy=義
h2=弘
h3=宏
h4=原
hb=橋
hc=彦
hd=秀
hf=心
hg=萩
hj=聖
hk=博
hl=葉
hm=公
hp=帆
hq=久
hr=裕
hs=濱
ht=人
hw=範
hx=平
hy=濵
hz=早
hn=本
jb=丈
jc=樹
jd=充
jf=嗣
jg=織
jh=仁
jk=治
jl=住
jm=嶋
jp=純
jr=真
js=順
jt=潤
jn=淳
k2=賢
k3=啓
k4=圭
k5=敬
k8=憲
kb=希
kc=華
kd=次
kf=花
kg=紀
kh=浩
kj=記
kl=孝
km=寛
kq=清
kr=香
ks=佳
kt=輝
kv=勝
kw=川
kx=小
ky=喜
kz=克
kn=健
l8=音
lb=矢
ld=横
lv=愛
m2=昌
m3=光
m8=宮
mb=基
mc=芽
md=向
mf=森
mg=磨
mk=亮
ml=萌
mp=紫
mr=村
ms=正
mt=松
mx=満
my=宮
mz=水
mn=元
ps=者
rc=涼
rid=乗
rf=荒
rg=悟
rh=朗
rj=郎
rk=理
rl=生
rm=路
rd=利
rq=莉
rs=里
rt=立
ry=御
rn=林
s2=節
s3=寿
s4=紳
sb=柴
cd=章
sd=貞
sf=史
sg=将
sh=周
sj=新
sk=介
sl=佐
sm=島
sq=栄
sr=彩
st=幸
sv=誠
sw=昭
sx=篠
sy=祥
sz=沢
sn=慎
t2=津
t3=塚
t4=崇
t5=徹
t8=瀧
t9=滝
tb=飛
tc=登
td=戸
th=達
tj=拓
tk=隆
tl=琢
tm=智
tp=寺
tq=泰
ts=俊
tv=谷
ty=豊
tn=田
wc=若
wg=羽
wh=白
wl=翔
ws=渡
wiv=波
wn=風
y2=佑
y4=行
yd=屋
yc=康
yf=由
yg=柳
yh=陽
yk=之
yl=洋
dm=山
yr=良
ys=安
yt=也
yv=勇
yw=世
yz=優
yn=哉
zf=前
zj=崎
zn=善
n2=信
n3=伸
nb=暢
nc=今
nd=直
nf=菜
ng=長
nh=那
nj=成
nk=中
nl=乃
nm=々
nr=奈
ns=西
nt=日
nw=庭
nz=望
bb=美
cc=斗
ff=北
gg=永
hh=広
jj=木
ll=結
mm=海
pp=春
rr=梨
ss=士
tt=高
vv=子
ww=和
xx=聡
yy=祐
zz=澤
a2=敦
a3=彰
a4=晃
ad=赤
ag=合
aj=秋
ak=亜
al=綾
am=天
ar=有
as=麻
at=篤
ax=杏
az=東
i2=百
i3=千
ib=胃
ic=市
id=井
if=稲
ig=偉
ih=伊
ij=維
ik=衣
il=紗
is=石
it=一
iw=岩
iz=依
uc=内
um=馬
up=植
ur=浦
hit=打
e2=悦
eb=枝
eg=江
eh=英
ek=益
em=恵
es=哲
ex=榎
ob=覚
oc=岡
og=緒
oh=央
hoj=伯
ok=男
or=己
os=雄
ot=夫
bak=椿
3ev=汐
3eg=流
bum=栞
bur=岐
bay=芭
bk=黒
ber=熊
bas=伴
cix=筑
cos=慧
cut=切
dog=德
dob=暖
fuk=舩
fus=舟
fat=晋
fot=足
fun=船
get=取
mid=碧
koc=匠
hac=遥
rih=張
hok=阪
hih=倖
kix=均
lit=灯
hed=頭
tow=樋
cop=比
hoh=穂
his=尚
haf=半
han=仲
koj=徐
jor=条
ku2=隈
vir=仮
lok=柏
ket=潔
koy=耀
oj=嘉
low=耕
yx=恭
ku1=隅
keb=顕
kes=建
keg=謙
kuk=國
piv=要
dl=宣
lef=左
sot=湊
bok=牧
mik=幹
kij=蒔
mak=巻
met=瞬
but=貢
mw=南
raj=恒
rek=廉
rix=倫
sib=芝
bor=境
sc=坂
cen=景
saj=定
geh=繁
mos=茂
jif=柊
zk=﨑
pub=示
sey=勢
sat=諭
son=壮
yog=奨
yoj=庄
yor=夜
yis=晶
yon=荘
jv=重
sej=関
sar=桜
sed=仙
pec=尊
yuk=雪
baf=橘
tof=揮
to3=亨
ta0=隆
cic=築
tim=巧
tam=玉
fom=冨
yij=頼
yik=賴
sut=竣
taj=丹
wal=亘
yat=栁
tac=舘
yos=芳
yas=靖
dat=嵩
zaj=㟢
zar=櫻
ka4=桂
3os=洲
men=舜
yoc=悠
noj=穣
wov=浪
nom=並
aig=捷
kaf=茜
jal=絢
aaz=梓
hal=浅
iik=壱
iow=巌
iiz=泉
iok=郁
hin=薄
3h=滉
cm=志
cg=貴
kok=匡
hag=反
him=姫
ler=晴
kus=楠
kez=梢
kuc=国
cun=叶
rw=倉
mal=栗
mas=政
daw=暁
tug=継
kah=角
fum=富
war=我
lug=唯
cv=颯
can=貫
kab=可
kag=科
kaj=果
kas=笠
kat=加
gas=賀
kib=綺
kid=起
kif=黄
kih=妃
kim=勤
kip=期
kir=規
kis=季
kiy=居
gij=技
kur=来
ked=楓
kej=慶
kem=兼
aez=畔
kor=航
kos=胡
goc=后
gh=吾
gom=護
sak=作
sas=笹
sig=滋
sic=資
sil=視
sim=似
sip=詩
sir=吏
lw=耕
siw=師
siz=静
jib=自
jid=児
jik=實
jim=爾
jis=岸
jit=実
jiz=慈
sud=須
sef=瀬
ser=芹
zeg=禅
zes=是
soc=磯
sog=礒
sok=則
soj=曽
sop=奏
sor=空
sos=想
sod=種
zos=造
tad=忠
taf=棚
tak=卓
taq=妙
tat=多
hes=馳
tig=虎
tin=細
dag=団
teh=手
ter=照
dek=台
dem=院
dx=出
toc=昇
toj=時
tom=朋
tor=鳥
tot=都
dom=留
dor=努
kum=君
nab=鍋
nad=灘
nal=稜
nam=名
nar=鳴
nas=茄
ner=根
ham=浜
har=侑
has=蓮
hat=畠
baj=場
bac=化
par=巴
hir=尋
fut=普
fuy=芙
heh=邊
hek=邉
hom=誉
hv=堀
hos=星
hot=保
mam=摩
mar=茉
mib=身
mic=道
mif=皆
mil=見
mir=未
mis=巳
muf=宗
muj=務
mj=明
moj=桒
mor=朝
moc=持
yak=宅
yal=崚
yam=耶
yay=弥
yuh=湯
yup=遊
ev=夕
yob=予
yoh=庸
yok=與
yot=与
ral=陵
rar=稀
rik=力
rim=李
rer=礼
ren=連
rof=呂
roh=弄
roj=老
rom=室
rop=綱
wac=輪
waj=脇
1x=一
2x=二
3x=三
4x=四
5x=五
6x=六
7x=七
8x=八
9x=九
kex=ヶ
uw=上
nn=野
far=遠
red=朱
tas=珠
gen=源
tut=筒
pj=邦
er=地
aio=相
rak=楽
wit=冬
kam=亀
sal=塩
neb=延
bun=分
bit=尾
hod=方
sac=迫
gon=権
dok=所
jok=條
mom=桃
ouj=皇
car=車
sab=榊
kek=気
nan=何
us=宇
net=網
kug=草
cus=刈
cuk=苅
nap=難
kuz=葛
taw=淡
hab=幅
eis=衛
ec=絵
cow=牛
noh=能
soz=創
hor=法
wat=幡
hik=斐
sel=貝
kom=駒
zb=瑞
dh=杉
gs=菅
cq=征
der=鹿
tej=展
ken=絹
cin=鎮
saw=爽
sow=副
was=鷲
haw=鷹
sad=砂
het=入
bod=板
fax=工
mog=旭
gof=後
neg=祢
oeh=瑛
oer=玲
oeg=琉
doj=童
ful=床
pum=梅
tuk=槻
mot=最
joh=常
gor=諒
tik=近
kak=掛
zas=財
wak=涌
kar=唐
nus=主
mek=毛
rit=律
kit=桐
ouk=王
ouc=乙
sum=翠
iat=威
sij=渋
sik=澁
mey=目
gad=園
nob=鼻
yuz=柚
tos=年
naw=苗
hus=家
liq=酒
wif=妻
c2=番
c3=号
col=色
tes=宝
cas=詠
ram=雨
giw=際
huh=狩
tub=坪
mon=門
tuy=宙
hen=辺
dum=積
rur=憂
tur=鶴
kun=訓
oog=荻
tog=統
god=豪
gus=串
uus=臼
cir=円
hil=丘
mok=桑
jo1=丞
mes=飯
res=服
oit=於
goj=譲
kot=琴
gaz=薗
nik=錦
tey=茶
waw=粟
maw=葵
luj=椎
zow=添
bew=蜂
way=祝
doh=堂
tum=詰
kik=柿
dp=池
sis=思
out=外
gur=暮
muk=椋
sun=素
ror=怜
eig=映
hol=穴
rac=快
pot=鉢
bis=菱
fuf=不
oek=桶
com=完
cud=雲
moy=紋
zab=座
nat=彅
naj=薙
haj=肇
tar=始
rok=了
goh=肥
wet=腰
hef=兵
fod=折
her=伶
mer=令
mol=守
oim=臣
3er=澪
gaw=替
had=堅
dow=影
fow=進
pat=親
oak=樫
ios=勲
iol=功
nis=栖
min=民
1.=一
2.=二
3.=三
4.=四
5.=五
aos=蒼
rod=柄
yub=指
ol=尾
fol=追
tek=猿
sif=品
oil=油
mul=倍
yad=宿
lot=布
roz=萬
bus=伏
mof=杜
tal=才
fig=形
rig=環
wil=意
tid=潮
nox=の
fir=初
cik=敷
por=港
kin=菊
ji1=欽
yan=梁
lur=惟
ben=紅
nov=ノ
aiz=藍
wom=女
cam=櫛
mig=右
for=鴨
bah=俣
rir=鏡
zof=像
gog=語
jur=余
pos=示
gol=錦
fog=霧
cap=岬
ker=計
iut=逸
big=巨
fok=又
mi1=箕
mi2=蓑
kev=ケ
deg=度
cit=鎌
zat=雑
gak=魁
mob=諸
don=殿
zok=続
fam=畑
woj=叔
aij=味
non=無
ox=米
zes=是
coq=濃
men=面
gem=込
uar=宥
fud=札
kaw=壁
eur=欧
lar=拡
las=縄
rec=至
yod=淀
rem=黎
sem=精
yoz=承
nit=晨
rin=麟
hon=奉
cok=釜
boj=慕
zom=染
hum=歌
o1=斉
o2=齊
o3=斎
o4=齋
oug=扇
how=湯
con=綿
hah=覇
tux=つ
zum=済
rah=羅
loc=鍵
si2=秦
ran=蘭
cup=容
nin=任
sah=陰
fed=飼
zay=在
uf=上
yag=焼
bar=昂
mi3=箕
mi4=簑
su1=斉
su2=齊
su3=斎
su4=齋
mit=魅
ga2=管
ruj=塁
rug=類
mod=余
dw=修
buk=壽
kog=興
mub=允
ruy=愉
gut=具
bey=豆
kew=渓
fur=先
jin=陣
gax=が
lun=稚
fuc=鮫
pam=椰
ney=寧
oik=及
rub=劉
rot=露
teb=典
ret=烈
ah=青
eir=瞳
rev=先
lad=剣
ta4=喬
win=当
tic=厚
pek=岳
tuf=房
ta1=辰
muw=允
nav=紺
wig=翼
vis=寄
hem=檜
dam=嶌
suy=陶
pas=逸
rav=稔
ves=対
ni3=嶺
ni2=峯
ni1=峰
ka8=茅
zub=傑
oud=奥
iih=紘
bir=緑
yow=用
zin=誌
cub=窪
kuw=食
oic=落
gey=芸
taz=畦
guc=郡
gug=群
jah=𣘺
ric=來
ruk=馨
kuj=淑
sen=占
jan=檀
kuy=喰
tel=鋼
moh=猛
sit=城
bag=袋
cek=格
siy=支
led=導
ses=盛
uum=梅
key=京
nen=念
yom=養
kk=下
3ot=鴻
rey=恋
y8=哉
fox=狐
zon=存
vil=邑
tol=総
jam=舛
wap=沼
gin=銀
eem=惠
med=薬
kiw=究
toz=歳
nez=然
cet=祖
lev=位
buy=舞
lk=好
rez=領
sus=舜
ras=嵐
tu1=辰
lus=碓
d3=竜
to5=透
bud=束
los=寄
bal=樽
ro1=僚
ro2=僚
ro3=遼
tun=雷
cak=餅
ro4=瞭
zer=零
sin=槙
ri3=彬
meb=銘
coh=響
ro5=燎
dew=脩
wis=笛
uir=瓜
oun=逢
buj=物
iec=氷
eit=待
aad=且
uut=現
tay=泊
ruh=刘
lj=字
ned=針
pep=準
den=伝
jo4=杰
lij=字
op=開
aiv=蔦
ed=育
nif=旻
si3=榛
wk=沼
ka1=粕
ros=論
hif=斐
qn=田
biy=寄
vib=振
kuf=蔡
eac=各
vot=鉢
ver=対
cur=曲
dep=発
wor=詞
gan=願
sex=摂
kav=馨
lut=堆
tiw=双
fug=旗
eud=教
hid=裏
jas=升
nev=稔
jaj=桝
mac=待
nih=匂
no3=晄
lub=蟹
pod=粉
xuk=ヵ
suq=末
bon=曙
oob=珂
3an=沖
cp=比
aam=尼
bel=帯
dir=乾
go=漢字インベーダ
nex=クリア
new=ゲーム
gam=オーバー
cot=ゲームオーバー
kay=了解